######                                        #
#                002                     #
#                 |                      #
#                 |                      #
#                001                     #
#                 |                      #
#                 |                      #
#                000                     #
#                                        #
#####