######                                                                                                                                                           #
#                                                        434       497--366--361  334--384--435  476                                                        #
#                                                         |                   |    |              |                                                         #
#                                                         |                   |    |              |                                                         #
#                                              477--443  425            386--354--321  338  313  380--445--446                                              #
#                                                    |    |              |         |    |    |    |    |                                                    #
#                                                    |    |              |         |    |    |    |    |                                                    #
#                                                   408  350  483  385  388  285  304  278  287--353  480                                                   #
#                                                    |    |    |    |    |    |    |    |    |                                                              #
#                                                    |    |    |    |    |    |    |    |    |                                                              #
#                                    442  461  426  392--281  223--169  257  253  240  196--224  255  373                                                   #
#                                     |    |    |         |         |    |    |    |    |         |    |                                                    #
#                                     |    |    |         |         |    |    |    |    |         |    |                                                    #
#                                    417  422--394--318--199--197--165--163--228  233--152  192--239--336--421                                              #
#                                     |              |                   |              |    |                                                              #
#                                     |              |                   |              |    |                                                              #
#                          491  453--351  444  374--340  328--200--204  148--178  143  147--154--184  282  363  389                                         #
#                           |         |    |                   |         |         |    |              |    |    |                                          #
#                           |         |    |                   |         |         |    |              |    |    |                                          #
#                          489  441  332  387  341--316  195  175--141  121--123--138--139--176  136--231--294--311--499                                    #
#                           |    |    |    |         |    |         |    |                        |                                                         #
#                           |    |    |    |         |    |         |    |                        |                                                         #
#                     396--391  319  295  331  307  292--185--155  107  111--114--120  172  146  109  186--262--390--398                                    #
#                           |    |    |    |    |              |    |    |              |    |    |    |              |                                     #
#                           |    |    |    |    |              |    |    |              |    |    |    |              |                                     #
#           452--428--411--324--289--250  277  208--166  140  082  102--064  101  093  132  086--095  098  245--343  487                                    #
#                 |                   |    |         |    |    |         |    |    |    |    |         |    |                                               #
#                 |                   |    |         |    |    |         |    |    |    |    |         |    |                                               #
#           451--429  397  357--342--221--174  210  161  063--061  033  060  091  051  073  084  078--090--142  381--431                                    #
#                      |                   |    |    |         |    |    |    |    |    |    |    |              |                                          #
#                      |                   |    |    |         |    |    |    |    |    |    |    |              |                                          #
#      492--400--399--358  352  297--207  124--112--106--079--046--017--028  037--042  056--067  075--088--125--238--293                                    #
#                      |    |         |                             |    |    |         |         |    |    |                                               #
#                      |    |         |                             |    |    |         |         |    |    |                                               #
#           414--365--333--303  171--168--137  085  074  032  047--014  030  031  027--055  048--053  103  198--270--300--320                               #
#                 |         |              |    |    |    |         |         |    |         |                             |                                #
#                 |         |              |    |    |    |         |         |    |         |                             |                                #
#                447  301--187--167--108--081--045--040--019--015--013--009  020--026  035--044--059--189--275--283--376  471                               #
#                                          |                             |    |         |                             |                                     #
#                                          |                             |    |         |                             |                                     #
#                436  470  227--194--128--092  069--041--036--021  004  007--012--018--034--039--071--150--251  325  468                                    #
#                 |    |              |    |    |    |         |    |    |         |         |    |              |                                          #
#                 |    |              |    |    |    |         |    |    |         |         |    |              |                                          #
#           465--368--284--254--205--162  100  072  076  011--003--000--001--022  024--025  052  115--160--214--246--412                                    #
#                      |                        |         |         |    |         |    |                                                                   #
#                      |                        |         |         |    |         |    |                                                                   #
#           479--418--349  274--222--190--129  089  083--080  016--008  002--010  029  043--049--119--131--329--407                                         #
#                 |                        |    |    |                   |    |    |    |         |                                                         #
#                 |                        |    |    |                   |    |    |    |         |                                                         #
#                463--458  379  226--225--105--104  099  058--023--006--005  038  054  077--130  219--305--330--454                                         #
#                      |    |    |              |    |         |    |    |                        |         |                                               #
#                      |    |    |              |    |         |    |    |                        |         |                                               #
#           486--462  359  266--260  235--158--126  122  068--057  062  050--070--087  182--211  242  326  348                                              #
#                 |    |                   |    |              |    |    |    |    |    |    |    |    |                                                    #
#                 |    |                   |    |              |    |    |    |    |    |    |    |    |                                                    #
#                367--344--230  243  180--164  135  145--113--094  065  066  116  117--170  248  286--288--498                                              #
#                           |    |              |    |         |    |    |    |    |         |    |                                                         #
#                           |    |              |    |         |    |    |    |    |         |    |                                                         #
#                339--314--220--215--177--156--149  183  153--097  134  096  159  127--173  272  309--377--456                                              #
#                 |                        |    |              |    |    |         |    |         |                                                         #
#                 |                        |    |              |    |    |         |    |         |                                                         #
#           482--404  258--236--216--213--209  191  188  157--110  144  179--201  212  202--249  371--430--440                                              #
#            |              |         |         |    |         |    |    |    |    |    |                                                                   #
#            |              |         |         |    |         |    |    |    |    |    |                                                                   #
#           484  433--372--263  271--217  241--193  151--133--118--218  181  206  229  267--302--402--403--439                                              #
#                           |    |         |    |         |         |         |    |                                                                        #
#                           |    |         |    |         |         |         |    |                                                                        #
#      494--457--355--312--299  310  327--256  203  247--234--259  252  244--232  237--370  364--401--427--474                                              #
#                      |    |         |    |    |    |    |    |    |    |    |              |    |    |                                                    #
#                      |    |         |    |    |    |    |    |    |    |    |              |    |    |                                                    #
#                437--347  356  469--362  279  269  369  280  291  261  264  265--273--298--360  420  438                                                   #
#                      |    |         |    |    |              |    |    |    |    |              |    |                                                    #
#                      |    |         |    |    |              |    |    |    |    |              |    |                                                    #
#                393--375  405  423--395  323  315--335--378  306  345  290  268  296--308--337  464  448--490                                              #
#                      |    |                   |    |    |    |    |         |    |    |    |         |                                                    #
#                      |    |                   |    |    |    |    |         |    |    |    |         |                                                    #
#           493--478--413  432--473       410--406  346  466  415  409  322--276  382  317  383       475                                                   #
#                      |    |                             |         |    |    |    |    |    |         |                                                    #
#                      |    |                             |         |    |    |    |    |    |         |                                                    #
#                     419  449--450                      472--495  488  424  459  455  416  460       496                                                   #
#                                                         |                   |                                                                             #
#                                                         |                   |                                                                             #
#                                                   485--481                 467                                                                            #
#                                                                                                                                                           #
#####